11111111111111111111
10C000000C00001C0101
100P01000010C0100111
1C001C100000000E0111
100100001C0000110011
11111000011101010001
10000011100001111C01
11111111111111111111