11111111111111111111
10C000000C00000C0001
100P00000000C0000001
1C000C000000000E0001
100000000C0000000001
10000000000000000001
10000000000000000C01
11111111111111111111