1111111111111111111111111111
10C000000C00001C010001000001
100P01000010C010011100011101
1C001C1000000000111100010001
100100001C000011001CC0100101
1111100001110101000000100001
10000011100001111C000C011011
111100001100C110000111110001
1C000000111100001100C1000001
1000E00011111000011001000001
1111111111111111111111111111