11111111111
10000000001
10000100001
10001C10001
10000000001
10000000001
10000000001
10000000001
10000000001
1000P0C00E1
11111111111