11111111111111111111
10000P1100000001C111
10000000000000010001
1000111000000C010111
10001E11110000000001
10000000110000000001
11111111111111111111